Context	 X3mer	 X1mer
AAAAA->C	AAA->C	A->C
AAAAA->G	AAA->G	A->G
AAAAA->T	AAA->T	A->T
AAAAC->C	AAA->C	A->C
AAAAC->G	AAA->G	A->G
AAAAC->T	AAA->T	A->T
AAAAG->C	AAA->C	A->C
AAAAG->G	AAA->G	A->G
AAAAG->T	AAA->T	A->T
AAAAT->C	AAA->C	A->C
AAAAT->G	AAA->G	A->G
AAAAT->T	AAA->T	A->T
AAACA->C	AAC->C	A->C
AAACA->G	AAC->G	A->G
AAACA->T	AAC->T	A->T
AAACC->C	AAC->C	A->C
AAACC->G	AAC->G	A->G
AAACC->T	AAC->T	A->T
AAACG->C	AAC->C	A->C
AAACG->G	AAC->G	A->G
AAACG->T	AAC->T	A->T
AAACT->C	AAC->C	A->C
AAACT->G	AAC->G	A->G
AAACT->T	AAC->T	A->T
AAAGA->C	AAG->C	A->C
AAAGA->G	AAG->G	A->G
AAAGA->T	AAG->T	A->T
AAAGC->C	AAG->C	A->C
AAAGC->G	AAG->G	A->G
AAAGC->T	AAG->T	A->T
AAAGG->C	AAG->C	A->C
AAAGG->G	AAG->G	A->G
AAAGG->T	AAG->T	A->T
AAAGT->C	AAG->C	A->C
AAAGT->G	AAG->G	A->G
AAAGT->T	AAG->T	A->T
AAATA->C	AAT->C	A->C
AAATA->G	AAT->G	A->G
AAATA->T	AAT->T	A->T
AAATC->C	AAT->C	A->C
AAATC->G	AAT->G	A->G
AAATC->T	AAT->T	A->T
AAATG->C	AAT->C	A->C
AAATG->G	AAT->G	A->G
AAATG->T	AAT->T	A->T
AAATT->C	AAT->C	A->C
AAATT->G	AAT->G	A->G
AAATT->T	AAT->T	A->T
AACAA->A	ACA->A	C->A
AACAA->G	ACA->G	C->G
AACAA->T	ACA->T	C->T
AACAC->A	ACA->A	C->A
AACAC->G	ACA->G	C->G
AACAC->T	ACA->T	C->T
AACAG->A	ACA->A	C->A
AACAG->G	ACA->G	C->G
AACAG->T	ACA->T	C->T
AACAT->A	ACA->A	C->A
AACAT->G	ACA->G	C->G
AACAT->T	ACA->T	C->T
AACCA->A	ACC->A	C->A
AACCA->G	ACC->G	C->G
AACCA->T	ACC->T	C->T
AACCC->A	ACC->A	C->A
AACCC->G	ACC->G	C->G
AACCC->T	ACC->T	C->T
AACCG->A	ACC->A	C->A
AACCG->G	ACC->G	C->G
AACCG->T	ACC->T	C->T
AACCT->A	ACC->A	C->A
AACCT->G	ACC->G	C->G
AACCT->T	ACC->T	C->T
AACGA->A	ACG->A	C->A
AACGA->G	ACG->G	C->G
AACGA->T	ACG->T	C->T
AACGC->A	ACG->A	C->A
AACGC->G	ACG->G	C->G
AACGC->T	ACG->T	C->T
AACGG->A	ACG->A	C->A
AACGG->G	ACG->G	C->G
AACGG->T	ACG->T	C->T
AACGT->A	ACG->A	C->A
AACGT->G	ACG->G	C->G
AACGT->T	ACG->T	C->T
AACTA->A	ACT->A	C->A
AACTA->G	ACT->G	C->G
AACTA->T	ACT->T	C->T
AACTC->A	ACT->A	C->A
AACTC->G	ACT->G	C->G
AACTC->T	ACT->T	C->T
AACTG->A	ACT->A	C->A
AACTG->G	ACT->G	C->G
AACTG->T	ACT->T	C->T
AACTT->A	ACT->A	C->A
AACTT->G	ACT->G	C->G
AACTT->T	ACT->T	C->T
TTCTT->T	TCT->T	C->T
TTCTT->G	TCT->G	C->G
TTCTT->A	TCT->A	C->A
GTCTT->T	TCT->T	C->T
GTCTT->G	TCT->G	C->G
GTCTT->A	TCT->A	C->A
CTCTT->T	TCT->T	C->T
CTCTT->G	TCT->G	C->G
CTCTT->A	TCT->A	C->A
ATCTT->T	TCT->T	C->T
ATCTT->G	TCT->G	C->G
ATCTT->A	TCT->A	C->A
TGCTT->T	GCT->T	C->T
TGCTT->G	GCT->G	C->G
TGCTT->A	GCT->A	C->A
GGCTT->T	GCT->T	C->T
GGCTT->G	GCT->G	C->G
GGCTT->A	GCT->A	C->A
CGCTT->T	GCT->T	C->T
CGCTT->G	GCT->G	C->G
CGCTT->A	GCT->A	C->A
AGCTT->T	GCT->T	C->T
AGCTT->G	GCT->G	C->G
AGCTT->A	GCT->A	C->A
TCCTT->T	CCT->T	C->T
TCCTT->G	CCT->G	C->G
TCCTT->A	CCT->A	C->A
GCCTT->T	CCT->T	C->T
GCCTT->G	CCT->G	C->G
GCCTT->A	CCT->A	C->A
CCCTT->T	CCT->T	C->T
CCCTT->G	CCT->G	C->G
CCCTT->A	CCT->A	C->A
ACCTT->T	CCT->T	C->T
ACCTT->G	CCT->G	C->G
ACCTT->A	CCT->A	C->A
TACTT->T	ACT->T	C->T
TACTT->G	ACT->G	C->G
TACTT->A	ACT->A	C->A
GACTT->T	ACT->T	C->T
GACTT->G	ACT->G	C->G
GACTT->A	ACT->A	C->A
CACTT->T	ACT->T	C->T
CACTT->G	ACT->G	C->G
CACTT->A	ACT->A	C->A
TTATT->T	TAT->T	A->T
TTATT->G	TAT->G	A->G
TTATT->C	TAT->C	A->C
GTATT->T	TAT->T	A->T
GTATT->G	TAT->G	A->G
GTATT->C	TAT->C	A->C
CTATT->T	TAT->T	A->T
CTATT->G	TAT->G	A->G
CTATT->C	TAT->C	A->C
ATATT->T	TAT->T	A->T
ATATT->G	TAT->G	A->G
ATATT->C	TAT->C	A->C
TGATT->T	GAT->T	A->T
TGATT->G	GAT->G	A->G
TGATT->C	GAT->C	A->C
GGATT->T	GAT->T	A->T
GGATT->G	GAT->G	A->G
GGATT->C	GAT->C	A->C
CGATT->T	GAT->T	A->T
CGATT->G	GAT->G	A->G
CGATT->C	GAT->C	A->C
AGATT->T	GAT->T	A->T
AGATT->G	GAT->G	A->G
AGATT->C	GAT->C	A->C
TCATT->T	CAT->T	A->T
TCATT->G	CAT->G	A->G
TCATT->C	CAT->C	A->C
GCATT->T	CAT->T	A->T
GCATT->G	CAT->G	A->G
GCATT->C	CAT->C	A->C
CCATT->T	CAT->T	A->T
CCATT->G	CAT->G	A->G
CCATT->C	CAT->C	A->C
ACATT->T	CAT->T	A->T
ACATT->G	CAT->G	A->G
ACATT->C	CAT->C	A->C
TAATT->T	AAT->T	A->T
TAATT->G	AAT->G	A->G
TAATT->C	AAT->C	A->C
GAATT->T	AAT->T	A->T
GAATT->G	AAT->G	A->G
GAATT->C	AAT->C	A->C
CAATT->T	AAT->T	A->T
CAATT->G	AAT->G	A->G
CAATT->C	AAT->C	A->C
ACAAA->C	CAA->C	A->C
ACAAA->G	CAA->G	A->G
ACAAA->T	CAA->T	A->T
ACAAC->C	CAA->C	A->C
ACAAC->G	CAA->G	A->G
ACAAC->T	CAA->T	A->T
ACAAG->C	CAA->C	A->C
ACAAG->G	CAA->G	A->G
ACAAG->T	CAA->T	A->T
ACAAT->C	CAA->C	A->C
ACAAT->G	CAA->G	A->G
ACAAT->T	CAA->T	A->T
ACACA->C	CAC->C	A->C
ACACA->G	CAC->G	A->G
ACACA->T	CAC->T	A->T
ACACC->C	CAC->C	A->C
ACACC->G	CAC->G	A->G
ACACC->T	CAC->T	A->T
ACACG->C	CAC->C	A->C
ACACG->G	CAC->G	A->G
ACACG->T	CAC->T	A->T
ACACT->C	CAC->C	A->C
ACACT->G	CAC->G	A->G
ACACT->T	CAC->T	A->T
ACAGA->C	CAG->C	A->C
ACAGA->G	CAG->G	A->G
ACAGA->T	CAG->T	A->T
ACAGC->C	CAG->C	A->C
ACAGC->G	CAG->G	A->G
ACAGC->T	CAG->T	A->T
ACAGG->C	CAG->C	A->C
ACAGG->G	CAG->G	A->G
ACAGG->T	CAG->T	A->T
ACAGT->C	CAG->C	A->C
ACAGT->G	CAG->G	A->G
ACAGT->T	CAG->T	A->T
ACATA->C	CAT->C	A->C
ACATA->G	CAT->G	A->G
ACATA->T	CAT->T	A->T
ACATC->C	CAT->C	A->C
ACATC->G	CAT->G	A->G
ACATC->T	CAT->T	A->T
ACATG->C	CAT->C	A->C
ACATG->G	CAT->G	A->G
ACATG->T	CAT->T	A->T
ACCAA->A	CCA->A	C->A
ACCAA->G	CCA->G	C->G
ACCAA->T	CCA->T	C->T
ACCAC->A	CCA->A	C->A
ACCAC->G	CCA->G	C->G
ACCAC->T	CCA->T	C->T
ACCAG->A	CCA->A	C->A
ACCAG->G	CCA->G	C->G
ACCAG->T	CCA->T	C->T
ACCAT->A	CCA->A	C->A
ACCAT->G	CCA->G	C->G
ACCAT->T	CCA->T	C->T
ACCCA->A	CCC->A	C->A
ACCCA->G	CCC->G	C->G
ACCCA->T	CCC->T	C->T
ACCCC->A	CCC->A	C->A
ACCCC->G	CCC->G	C->G
ACCCC->T	CCC->T	C->T
ACCCG->A	CCC->A	C->A
ACCCG->G	CCC->G	C->G
ACCCG->T	CCC->T	C->T
ACCCT->A	CCC->A	C->A
ACCCT->G	CCC->G	C->G
ACCCT->T	CCC->T	C->T
ACCGA->A	CCG->A	C->A
ACCGA->G	CCG->G	C->G
ACCGA->T	CCG->T	C->T
ACCGC->A	CCG->A	C->A
ACCGC->G	CCG->G	C->G
ACCGC->T	CCG->T	C->T
ACCGG->A	CCG->A	C->A
ACCGG->G	CCG->G	C->G
ACCGG->T	CCG->T	C->T
ACCGT->A	CCG->A	C->A
ACCGT->G	CCG->G	C->G
ACCGT->T	CCG->T	C->T
ACCTA->A	CCT->A	C->A
ACCTA->G	CCT->G	C->G
ACCTA->T	CCT->T	C->T
ACCTC->A	CCT->A	C->A
ACCTC->G	CCT->G	C->G
ACCTC->T	CCT->T	C->T
ACCTG->A	CCT->A	C->A
ACCTG->G	CCT->G	C->G
ACCTG->T	CCT->T	C->T
TTCGT->T	TCG->T	C->T
TTCGT->G	TCG->G	C->G
TTCGT->A	TCG->A	C->A
GTCGT->T	TCG->T	C->T
GTCGT->G	TCG->G	C->G
GTCGT->A	TCG->A	C->A
CTCGT->T	TCG->T	C->T
CTCGT->G	TCG->G	C->G
CTCGT->A	TCG->A	C->A
ATCGT->T	TCG->T	C->T
ATCGT->G	TCG->G	C->G
ATCGT->A	TCG->A	C->A
TGCGT->T	GCG->T	C->T
TGCGT->G	GCG->G	C->G
TGCGT->A	GCG->A	C->A
GGCGT->T	GCG->T	C->T
GGCGT->G	GCG->G	C->G
GGCGT->A	GCG->A	C->A
CGCGT->T	GCG->T	C->T
CGCGT->G	GCG->G	C->G
CGCGT->A	GCG->A	C->A
AGCGT->T	GCG->T	C->T
AGCGT->G	GCG->G	C->G
AGCGT->A	GCG->A	C->A
TCCGT->T	CCG->T	C->T
TCCGT->G	CCG->G	C->G
TCCGT->A	CCG->A	C->A
GCCGT->T	CCG->T	C->T
GCCGT->G	CCG->G	C->G
GCCGT->A	CCG->A	C->A
CCCGT->T	CCG->T	C->T
CCCGT->G	CCG->G	C->G
CCCGT->A	CCG->A	C->A
TACGT->T	ACG->T	C->T
TACGT->G	ACG->G	C->G
TACGT->A	ACG->A	C->A
GACGT->T	ACG->T	C->T
GACGT->G	ACG->G	C->G
GACGT->A	ACG->A	C->A
CACGT->T	ACG->T	C->T
CACGT->G	ACG->G	C->G
CACGT->A	ACG->A	C->A
TTAGT->T	TAG->T	A->T
TTAGT->G	TAG->G	A->G
TTAGT->C	TAG->C	A->C
GTAGT->T	TAG->T	A->T
GTAGT->G	TAG->G	A->G
GTAGT->C	TAG->C	A->C
CTAGT->T	TAG->T	A->T
CTAGT->G	TAG->G	A->G
CTAGT->C	TAG->C	A->C
ATAGT->T	TAG->T	A->T
ATAGT->G	TAG->G	A->G
ATAGT->C	TAG->C	A->C
TGAGT->T	GAG->T	A->T
TGAGT->G	GAG->G	A->G
TGAGT->C	GAG->C	A->C
GGAGT->T	GAG->T	A->T
GGAGT->G	GAG->G	A->G
GGAGT->C	GAG->C	A->C
CGAGT->T	GAG->T	A->T
CGAGT->G	GAG->G	A->G
CGAGT->C	GAG->C	A->C
AGAGT->T	GAG->T	A->T
AGAGT->G	GAG->G	A->G
AGAGT->C	GAG->C	A->C
TCAGT->T	CAG->T	A->T
TCAGT->G	CAG->G	A->G
TCAGT->C	CAG->C	A->C
GCAGT->T	CAG->T	A->T
GCAGT->G	CAG->G	A->G
GCAGT->C	CAG->C	A->C
CCAGT->T	CAG->T	A->T
CCAGT->G	CAG->G	A->G
CCAGT->C	CAG->C	A->C
TAAGT->T	AAG->T	A->T
TAAGT->G	AAG->G	A->G
TAAGT->C	AAG->C	A->C
GAAGT->T	AAG->T	A->T
GAAGT->G	AAG->G	A->G
GAAGT->C	AAG->C	A->C
CAAGT->T	AAG->T	A->T
CAAGT->G	AAG->G	A->G
CAAGT->C	AAG->C	A->C
AGAAA->C	GAA->C	A->C
AGAAA->G	GAA->G	A->G
AGAAA->T	GAA->T	A->T
AGAAC->C	GAA->C	A->C
AGAAC->G	GAA->G	A->G
AGAAC->T	GAA->T	A->T
AGAAG->C	GAA->C	A->C
AGAAG->G	GAA->G	A->G
AGAAG->T	GAA->T	A->T
AGAAT->C	GAA->C	A->C
AGAAT->G	GAA->G	A->G
AGAAT->T	GAA->T	A->T
AGACA->C	GAC->C	A->C
AGACA->G	GAC->G	A->G
AGACA->T	GAC->T	A->T
AGACC->C	GAC->C	A->C
AGACC->G	GAC->G	A->G
AGACC->T	GAC->T	A->T
AGACG->C	GAC->C	A->C
AGACG->G	GAC->G	A->G
AGACG->T	GAC->T	A->T
AGACT->C	GAC->C	A->C
AGACT->G	GAC->G	A->G
AGACT->T	GAC->T	A->T
AGAGA->C	GAG->C	A->C
AGAGA->G	GAG->G	A->G
AGAGA->T	GAG->T	A->T
AGAGC->C	GAG->C	A->C
AGAGC->G	GAG->G	A->G
AGAGC->T	GAG->T	A->T
AGAGG->C	GAG->C	A->C
AGAGG->G	GAG->G	A->G
AGAGG->T	GAG->T	A->T
AGATA->C	GAT->C	A->C
AGATA->G	GAT->G	A->G
AGATA->T	GAT->T	A->T
AGATC->C	GAT->C	A->C
AGATC->G	GAT->G	A->G
AGATC->T	GAT->T	A->T
AGATG->C	GAT->C	A->C
AGATG->G	GAT->G	A->G
AGATG->T	GAT->T	A->T
AGCAA->A	GCA->A	C->A
AGCAA->G	GCA->G	C->G
AGCAA->T	GCA->T	C->T
AGCAC->A	GCA->A	C->A
AGCAC->G	GCA->G	C->G
AGCAC->T	GCA->T	C->T
AGCAG->A	GCA->A	C->A
AGCAG->G	GCA->G	C->G
AGCAG->T	GCA->T	C->T
AGCAT->A	GCA->A	C->A
AGCAT->G	GCA->G	C->G
AGCAT->T	GCA->T	C->T
AGCCA->A	GCC->A	C->A
AGCCA->G	GCC->G	C->G
AGCCA->T	GCC->T	C->T
AGCCC->A	GCC->A	C->A
AGCCC->G	GCC->G	C->G
AGCCC->T	GCC->T	C->T
AGCCG->A	GCC->A	C->A
AGCCG->G	GCC->G	C->G
AGCCG->T	GCC->T	C->T
AGCCT->A	GCC->A	C->A
AGCCT->G	GCC->G	C->G
AGCCT->T	GCC->T	C->T
AGCGA->A	GCG->A	C->A
AGCGA->G	GCG->G	C->G
AGCGA->T	GCG->T	C->T
AGCGC->A	GCG->A	C->A
AGCGC->G	GCG->G	C->G
AGCGC->T	GCG->T	C->T
AGCGG->A	GCG->A	C->A
AGCGG->G	GCG->G	C->G
AGCGG->T	GCG->T	C->T
AGCTA->A	GCT->A	C->A
AGCTA->G	GCT->G	C->G
AGCTA->T	GCT->T	C->T
AGCTC->A	GCT->A	C->A
AGCTC->G	GCT->G	C->G
AGCTC->T	GCT->T	C->T
AGCTG->A	GCT->A	C->A
AGCTG->G	GCT->G	C->G
AGCTG->T	GCT->T	C->T
TTCCT->T	TCC->T	C->T
TTCCT->G	TCC->G	C->G
TTCCT->A	TCC->A	C->A
GTCCT->T	TCC->T	C->T
GTCCT->G	TCC->G	C->G
GTCCT->A	TCC->A	C->A
CTCCT->T	TCC->T	C->T
CTCCT->G	TCC->G	C->G
CTCCT->A	TCC->A	C->A
ATCCT->T	TCC->T	C->T
ATCCT->G	TCC->G	C->G
ATCCT->A	TCC->A	C->A
TGCCT->T	GCC->T	C->T
TGCCT->G	GCC->G	C->G
TGCCT->A	GCC->A	C->A
GGCCT->T	GCC->T	C->T
GGCCT->G	GCC->G	C->G
GGCCT->A	GCC->A	C->A
CGCCT->T	GCC->T	C->T
CGCCT->G	GCC->G	C->G
CGCCT->A	GCC->A	C->A
TCCCT->T	CCC->T	C->T
TCCCT->G	CCC->G	C->G
TCCCT->A	CCC->A	C->A
GCCCT->T	CCC->T	C->T
GCCCT->G	CCC->G	C->G
GCCCT->A	CCC->A	C->A
CCCCT->T	CCC->T	C->T
CCCCT->G	CCC->G	C->G
CCCCT->A	CCC->A	C->A
TACCT->T	ACC->T	C->T
TACCT->G	ACC->G	C->G
TACCT->A	ACC->A	C->A
GACCT->T	ACC->T	C->T
GACCT->G	ACC->G	C->G
GACCT->A	ACC->A	C->A
CACCT->T	ACC->T	C->T
CACCT->G	ACC->G	C->G
CACCT->A	ACC->A	C->A
TTACT->T	TAC->T	A->T
TTACT->G	TAC->G	A->G
TTACT->C	TAC->C	A->C
GTACT->T	TAC->T	A->T
GTACT->G	TAC->G	A->G
GTACT->C	TAC->C	A->C
CTACT->T	TAC->T	A->T
CTACT->G	TAC->G	A->G
CTACT->C	TAC->C	A->C
ATACT->T	TAC->T	A->T
ATACT->G	TAC->G	A->G
ATACT->C	TAC->C	A->C
TGACT->T	GAC->T	A->T
TGACT->G	GAC->G	A->G
TGACT->C	GAC->C	A->C
GGACT->T	GAC->T	A->T
GGACT->G	GAC->G	A->G
GGACT->C	GAC->C	A->C
CGACT->T	GAC->T	A->T
CGACT->G	GAC->G	A->G
CGACT->C	GAC->C	A->C
TCACT->T	CAC->T	A->T
TCACT->G	CAC->G	A->G
TCACT->C	CAC->C	A->C
GCACT->T	CAC->T	A->T
GCACT->G	CAC->G	A->G
GCACT->C	CAC->C	A->C
CCACT->T	CAC->T	A->T
CCACT->G	CAC->G	A->G
CCACT->C	CAC->C	A->C
TAACT->T	AAC->T	A->T
TAACT->G	AAC->G	A->G
TAACT->C	AAC->C	A->C
GAACT->T	AAC->T	A->T
GAACT->G	AAC->G	A->G
GAACT->C	AAC->C	A->C
CAACT->T	AAC->T	A->T
CAACT->G	AAC->G	A->G
CAACT->C	AAC->C	A->C
ATAAA->C	TAA->C	A->C
ATAAA->G	TAA->G	A->G
ATAAA->T	TAA->T	A->T
ATAAC->C	TAA->C	A->C
ATAAC->G	TAA->G	A->G
ATAAC->T	TAA->T	A->T
ATAAG->C	TAA->C	A->C
ATAAG->G	TAA->G	A->G
ATAAG->T	TAA->T	A->T
ATAAT->C	TAA->C	A->C
ATAAT->G	TAA->G	A->G
ATAAT->T	TAA->T	A->T
ATACA->C	TAC->C	A->C
ATACA->G	TAC->G	A->G
ATACA->T	TAC->T	A->T
ATACC->C	TAC->C	A->C
ATACC->G	TAC->G	A->G
ATACC->T	TAC->T	A->T
ATACG->C	TAC->C	A->C
ATACG->G	TAC->G	A->G
ATACG->T	TAC->T	A->T
ATAGA->C	TAG->C	A->C
ATAGA->G	TAG->G	A->G
ATAGA->T	TAG->T	A->T
ATAGC->C	TAG->C	A->C
ATAGC->G	TAG->G	A->G
ATAGC->T	TAG->T	A->T
ATAGG->C	TAG->C	A->C
ATAGG->G	TAG->G	A->G
ATAGG->T	TAG->T	A->T
ATATA->C	TAT->C	A->C
ATATA->G	TAT->G	A->G
ATATA->T	TAT->T	A->T
ATATC->C	TAT->C	A->C
ATATC->G	TAT->G	A->G
ATATC->T	TAT->T	A->T
ATATG->C	TAT->C	A->C
ATATG->G	TAT->G	A->G
ATATG->T	TAT->T	A->T
ATCAA->A	TCA->A	C->A
ATCAA->G	TCA->G	C->G
ATCAA->T	TCA->T	C->T
ATCAC->A	TCA->A	C->A
ATCAC->G	TCA->G	C->G
ATCAC->T	TCA->T	C->T
ATCAG->A	TCA->A	C->A
ATCAG->G	TCA->G	C->G
ATCAG->T	TCA->T	C->T
ATCAT->A	TCA->A	C->A
ATCAT->G	TCA->G	C->G
ATCAT->T	TCA->T	C->T
ATCCA->A	TCC->A	C->A
ATCCA->G	TCC->G	C->G
ATCCA->T	TCC->T	C->T
ATCCC->A	TCC->A	C->A
ATCCC->G	TCC->G	C->G
ATCCC->T	TCC->T	C->T
ATCCG->A	TCC->A	C->A
ATCCG->G	TCC->G	C->G
ATCCG->T	TCC->T	C->T
ATCGA->A	TCG->A	C->A
ATCGA->G	TCG->G	C->G
ATCGA->T	TCG->T	C->T
ATCGC->A	TCG->A	C->A
ATCGC->G	TCG->G	C->G
ATCGC->T	TCG->T	C->T
ATCGG->A	TCG->A	C->A
ATCGG->G	TCG->G	C->G
ATCGG->T	TCG->T	C->T
ATCTA->A	TCT->A	C->A
ATCTA->G	TCT->G	C->G
ATCTA->T	TCT->T	C->T
ATCTC->A	TCT->A	C->A
ATCTC->G	TCT->G	C->G
ATCTC->T	TCT->T	C->T
ATCTG->A	TCT->A	C->A
ATCTG->G	TCT->G	C->G
ATCTG->T	TCT->T	C->T
TTCAT->T	TCA->T	C->T
TTCAT->G	TCA->G	C->G
TTCAT->A	TCA->A	C->A
GTCAT->T	TCA->T	C->T
GTCAT->G	TCA->G	C->G
GTCAT->A	TCA->A	C->A
CTCAT->T	TCA->T	C->T
CTCAT->G	TCA->G	C->G
CTCAT->A	TCA->A	C->A
TGCAT->T	GCA->T	C->T
TGCAT->G	GCA->G	C->G
TGCAT->A	GCA->A	C->A
GGCAT->T	GCA->T	C->T
GGCAT->G	GCA->G	C->G
GGCAT->A	GCA->A	C->A
CGCAT->T	GCA->T	C->T
CGCAT->G	GCA->G	C->G
CGCAT->A	GCA->A	C->A
TCCAT->T	CCA->T	C->T
TCCAT->G	CCA->G	C->G
TCCAT->A	CCA->A	C->A
GCCAT->T	CCA->T	C->T
GCCAT->G	CCA->G	C->G
GCCAT->A	CCA->A	C->A
CCCAT->T	CCA->T	C->T
CCCAT->G	CCA->G	C->G
CCCAT->A	CCA->A	C->A
TACAT->T	ACA->T	C->T
TACAT->G	ACA->G	C->G
TACAT->A	ACA->A	C->A
GACAT->T	ACA->T	C->T
GACAT->G	ACA->G	C->G
GACAT->A	ACA->A	C->A
CACAT->T	ACA->T	C->T
CACAT->G	ACA->G	C->G
CACAT->A	ACA->A	C->A
TTAAT->T	TAA->T	A->T
TTAAT->G	TAA->G	A->G
TTAAT->C	TAA->C	A->C
GTAAT->T	TAA->T	A->T
GTAAT->G	TAA->G	A->G
GTAAT->C	TAA->C	A->C
CTAAT->T	TAA->T	A->T
CTAAT->G	TAA->G	A->G
CTAAT->C	TAA->C	A->C
TGAAT->T	GAA->T	A->T
TGAAT->G	GAA->G	A->G
TGAAT->C	GAA->C	A->C
GGAAT->T	GAA->T	A->T
GGAAT->G	GAA->G	A->G
GGAAT->C	GAA->C	A->C
CGAAT->T	GAA->T	A->T
CGAAT->G	GAA->G	A->G
CGAAT->C	GAA->C	A->C
TCAAT->T	CAA->T	A->T
TCAAT->G	CAA->G	A->G
TCAAT->C	CAA->C	A->C
GCAAT->T	CAA->T	A->T
GCAAT->G	CAA->G	A->G
GCAAT->C	CAA->C	A->C
CCAAT->T	CAA->T	A->T
CCAAT->G	CAA->G	A->G
CCAAT->C	CAA->C	A->C
TAAAT->T	AAA->T	A->T
TAAAT->G	AAA->G	A->G
TAAAT->C	AAA->C	A->C
GAAAT->T	AAA->T	A->T
GAAAT->G	AAA->G	A->G
GAAAT->C	AAA->C	A->C
CAAAT->T	AAA->T	A->T
CAAAT->G	AAA->G	A->G
CAAAT->C	AAA->C	A->C
CAAAA->C	AAA->C	A->C
CAAAA->G	AAA->G	A->G
CAAAA->T	AAA->T	A->T
CAAAC->C	AAA->C	A->C
CAAAC->G	AAA->G	A->G
CAAAC->T	AAA->T	A->T
CAAAG->C	AAA->C	A->C
CAAAG->G	AAA->G	A->G
CAAAG->T	AAA->T	A->T
CAACA->C	AAC->C	A->C
CAACA->G	AAC->G	A->G
CAACA->T	AAC->T	A->T
CAACC->C	AAC->C	A->C
CAACC->G	AAC->G	A->G
CAACC->T	AAC->T	A->T
CAACG->C	AAC->C	A->C
CAACG->G	AAC->G	A->G
CAACG->T	AAC->T	A->T
CAAGA->C	AAG->C	A->C
CAAGA->G	AAG->G	A->G
CAAGA->T	AAG->T	A->T
CAAGC->C	AAG->C	A->C
CAAGC->G	AAG->G	A->G
CAAGC->T	AAG->T	A->T
CAAGG->C	AAG->C	A->C
CAAGG->G	AAG->G	A->G
CAAGG->T	AAG->T	A->T
CAATA->C	AAT->C	A->C
CAATA->G	AAT->G	A->G
CAATA->T	AAT->T	A->T
CAATC->C	AAT->C	A->C
CAATC->G	AAT->G	A->G
CAATC->T	AAT->T	A->T
CAATG->C	AAT->C	A->C
CAATG->G	AAT->G	A->G
CAATG->T	AAT->T	A->T
CACAA->A	ACA->A	C->A
CACAA->G	ACA->G	C->G
CACAA->T	ACA->T	C->T
CACAC->A	ACA->A	C->A
CACAC->G	ACA->G	C->G
CACAC->T	ACA->T	C->T
CACAG->A	ACA->A	C->A
CACAG->G	ACA->G	C->G
CACAG->T	ACA->T	C->T
CACCA->A	ACC->A	C->A
CACCA->G	ACC->G	C->G
CACCA->T	ACC->T	C->T
CACCC->A	ACC->A	C->A
CACCC->G	ACC->G	C->G
CACCC->T	ACC->T	C->T
CACCG->A	ACC->A	C->A
CACCG->G	ACC->G	C->G
CACCG->T	ACC->T	C->T
CACGA->A	ACG->A	C->A
CACGA->G	ACG->G	C->G
CACGA->T	ACG->T	C->T
CACGC->A	ACG->A	C->A
CACGC->G	ACG->G	C->G
CACGC->T	ACG->T	C->T
CACGG->A	ACG->A	C->A
CACGG->G	ACG->G	C->G
CACGG->T	ACG->T	C->T
CACTA->A	ACT->A	C->A
CACTA->G	ACT->G	C->G
CACTA->T	ACT->T	C->T
CACTC->A	ACT->A	C->A
CACTC->G	ACT->G	C->G
CACTC->T	ACT->T	C->T
CACTG->A	ACT->A	C->A
CACTG->G	ACT->G	C->G
CACTG->T	ACT->T	C->T
TTCTG->T	TCT->T	C->T
TTCTG->G	TCT->G	C->G
TTCTG->A	TCT->A	C->A
GTCTG->T	TCT->T	C->T
GTCTG->G	TCT->G	C->G
GTCTG->A	TCT->A	C->A
CTCTG->T	TCT->T	C->T
CTCTG->G	TCT->G	C->G
CTCTG->A	TCT->A	C->A
TGCTG->T	GCT->T	C->T
TGCTG->G	GCT->G	C->G
TGCTG->A	GCT->A	C->A
GGCTG->T	GCT->T	C->T
GGCTG->G	GCT->G	C->G
GGCTG->A	GCT->A	C->A
CGCTG->T	GCT->T	C->T
CGCTG->G	GCT->G	C->G
CGCTG->A	GCT->A	C->A
TCCTG->T	CCT->T	C->T
TCCTG->G	CCT->G	C->G
TCCTG->A	CCT->A	C->A
GCCTG->T	CCT->T	C->T
GCCTG->G	CCT->G	C->G
GCCTG->A	CCT->A	C->A
CCCTG->T	CCT->T	C->T
CCCTG->G	CCT->G	C->G
CCCTG->A	CCT->A	C->A
TACTG->T	ACT->T	C->T
TACTG->G	ACT->G	C->G
TACTG->A	ACT->A	C->A
GACTG->T	ACT->T	C->T
GACTG->G	ACT->G	C->G
GACTG->A	ACT->A	C->A
TTATG->T	TAT->T	A->T
TTATG->G	TAT->G	A->G
TTATG->C	TAT->C	A->C
GTATG->T	TAT->T	A->T
GTATG->G	TAT->G	A->G
GTATG->C	TAT->C	A->C
CTATG->T	TAT->T	A->T
CTATG->G	TAT->G	A->G
CTATG->C	TAT->C	A->C
TGATG->T	GAT->T	A->T
TGATG->G	GAT->G	A->G
TGATG->C	GAT->C	A->C
GGATG->T	GAT->T	A->T
GGATG->G	GAT->G	A->G
GGATG->C	GAT->C	A->C
CGATG->T	GAT->T	A->T
CGATG->G	GAT->G	A->G
CGATG->C	GAT->C	A->C
TCATG->T	CAT->T	A->T
TCATG->G	CAT->G	A->G
TCATG->C	CAT->C	A->C
GCATG->T	CAT->T	A->T
GCATG->G	CAT->G	A->G
GCATG->C	CAT->C	A->C
CCATG->T	CAT->T	A->T
CCATG->G	CAT->G	A->G
CCATG->C	CAT->C	A->C
TAATG->T	AAT->T	A->T
TAATG->G	AAT->G	A->G
TAATG->C	AAT->C	A->C
GAATG->T	AAT->T	A->T
GAATG->G	AAT->G	A->G
GAATG->C	AAT->C	A->C
CCAAA->C	CAA->C	A->C
CCAAA->G	CAA->G	A->G
CCAAA->T	CAA->T	A->T
CCAAC->C	CAA->C	A->C
CCAAC->G	CAA->G	A->G
CCAAC->T	CAA->T	A->T
CCAAG->C	CAA->C	A->C
CCAAG->G	CAA->G	A->G
CCAAG->T	CAA->T	A->T
CCACA->C	CAC->C	A->C
CCACA->G	CAC->G	A->G
CCACA->T	CAC->T	A->T
CCACC->C	CAC->C	A->C
CCACC->G	CAC->G	A->G
CCACC->T	CAC->T	A->T
CCACG->C	CAC->C	A->C
CCACG->G	CAC->G	A->G
CCACG->T	CAC->T	A->T
CCAGA->C	CAG->C	A->C
CCAGA->G	CAG->G	A->G
CCAGA->T	CAG->T	A->T
CCAGC->C	CAG->C	A->C
CCAGC->G	CAG->G	A->G
CCAGC->T	CAG->T	A->T
CCAGG->C	CAG->C	A->C
CCAGG->G	CAG->G	A->G
CCAGG->T	CAG->T	A->T
CCATA->C	CAT->C	A->C
CCATA->G	CAT->G	A->G
CCATA->T	CAT->T	A->T
CCATC->C	CAT->C	A->C
CCATC->G	CAT->G	A->G
CCATC->T	CAT->T	A->T
CCCAA->A	CCA->A	C->A
CCCAA->G	CCA->G	C->G
CCCAA->T	CCA->T	C->T
CCCAC->A	CCA->A	C->A
CCCAC->G	CCA->G	C->G
CCCAC->T	CCA->T	C->T
CCCAG->A	CCA->A	C->A
CCCAG->G	CCA->G	C->G
CCCAG->T	CCA->T	C->T
CCCCA->A	CCC->A	C->A
CCCCA->G	CCC->G	C->G
CCCCA->T	CCC->T	C->T
CCCCC->A	CCC->A	C->A
CCCCC->G	CCC->G	C->G
CCCCC->T	CCC->T	C->T
CCCCG->A	CCC->A	C->A
CCCCG->G	CCC->G	C->G
CCCCG->T	CCC->T	C->T
CCCGA->A	CCG->A	C->A
CCCGA->G	CCG->G	C->G
CCCGA->T	CCG->T	C->T
CCCGC->A	CCG->A	C->A
CCCGC->G	CCG->G	C->G
CCCGC->T	CCG->T	C->T
CCCGG->A	CCG->A	C->A
CCCGG->G	CCG->G	C->G
CCCGG->T	CCG->T	C->T
CCCTA->A	CCT->A	C->A
CCCTA->G	CCT->G	C->G
CCCTA->T	CCT->T	C->T
CCCTC->A	CCT->A	C->A
CCCTC->G	CCT->G	C->G
CCCTC->T	CCT->T	C->T
TTCGG->T	TCG->T	C->T
TTCGG->G	TCG->G	C->G
TTCGG->A	TCG->A	C->A
GTCGG->T	TCG->T	C->T
GTCGG->G	TCG->G	C->G
GTCGG->A	TCG->A	C->A
CTCGG->T	TCG->T	C->T
CTCGG->G	TCG->G	C->G
CTCGG->A	TCG->A	C->A
TGCGG->T	GCG->T	C->T
TGCGG->G	GCG->G	C->G
TGCGG->A	GCG->A	C->A
GGCGG->T	GCG->T	C->T
GGCGG->G	GCG->G	C->G
GGCGG->A	GCG->A	C->A
CGCGG->T	GCG->T	C->T
CGCGG->G	GCG->G	C->G
CGCGG->A	GCG->A	C->A
TCCGG->T	CCG->T	C->T
TCCGG->G	CCG->G	C->G
TCCGG->A	CCG->A	C->A
GCCGG->T	CCG->T	C->T
GCCGG->G	CCG->G	C->G
GCCGG->A	CCG->A	C->A
TACGG->T	ACG->T	C->T
TACGG->G	ACG->G	C->G
TACGG->A	ACG->A	C->A
GACGG->T	ACG->T	C->T
GACGG->G	ACG->G	C->G
GACGG->A	ACG->A	C->A
TTAGG->T	TAG->T	A->T
TTAGG->G	TAG->G	A->G
TTAGG->C	TAG->C	A->C
GTAGG->T	TAG->T	A->T
GTAGG->G	TAG->G	A->G
GTAGG->C	TAG->C	A->C
CTAGG->T	TAG->T	A->T
CTAGG->G	TAG->G	A->G
CTAGG->C	TAG->C	A->C
TGAGG->T	GAG->T	A->T
TGAGG->G	GAG->G	A->G
TGAGG->C	GAG->C	A->C
GGAGG->T	GAG->T	A->T
GGAGG->G	GAG->G	A->G
GGAGG->C	GAG->C	A->C
CGAGG->T	GAG->T	A->T
CGAGG->G	GAG->G	A->G
CGAGG->C	GAG->C	A->C
TCAGG->T	CAG->T	A->T
TCAGG->G	CAG->G	A->G
TCAGG->C	CAG->C	A->C
GCAGG->T	CAG->T	A->T
GCAGG->G	CAG->G	A->G
GCAGG->C	CAG->C	A->C
TAAGG->T	AAG->T	A->T
TAAGG->G	AAG->G	A->G
TAAGG->C	AAG->C	A->C
GAAGG->T	AAG->T	A->T
GAAGG->G	AAG->G	A->G
GAAGG->C	AAG->C	A->C
CGAAA->C	GAA->C	A->C
CGAAA->G	GAA->G	A->G
CGAAA->T	GAA->T	A->T
CGAAC->C	GAA->C	A->C
CGAAC->G	GAA->G	A->G
CGAAC->T	GAA->T	A->T
CGAAG->C	GAA->C	A->C
CGAAG->G	GAA->G	A->G
CGAAG->T	GAA->T	A->T
CGACA->C	GAC->C	A->C
CGACA->G	GAC->G	A->G
CGACA->T	GAC->T	A->T
CGACC->C	GAC->C	A->C
CGACC->G	GAC->G	A->G
CGACC->T	GAC->T	A->T
CGACG->C	GAC->C	A->C
CGACG->G	GAC->G	A->G
CGACG->T	GAC->T	A->T
CGAGA->C	GAG->C	A->C
CGAGA->G	GAG->G	A->G
CGAGA->T	GAG->T	A->T
CGAGC->C	GAG->C	A->C
CGAGC->G	GAG->G	A->G
CGAGC->T	GAG->T	A->T
CGATA->C	GAT->C	A->C
CGATA->G	GAT->G	A->G
CGATA->T	GAT->T	A->T
CGATC->C	GAT->C	A->C
CGATC->G	GAT->G	A->G
CGATC->T	GAT->T	A->T
CGCAA->A	GCA->A	C->A
CGCAA->G	GCA->G	C->G
CGCAA->T	GCA->T	C->T
CGCAC->A	GCA->A	C->A
CGCAC->G	GCA->G	C->G
CGCAC->T	GCA->T	C->T
CGCAG->A	GCA->A	C->A
CGCAG->G	GCA->G	C->G
CGCAG->T	GCA->T	C->T
CGCCA->A	GCC->A	C->A
CGCCA->G	GCC->G	C->G
CGCCA->T	GCC->T	C->T
CGCCC->A	GCC->A	C->A
CGCCC->G	GCC->G	C->G
CGCCC->T	GCC->T	C->T
CGCCG->A	GCC->A	C->A
CGCCG->G	GCC->G	C->G
CGCCG->T	GCC->T	C->T
CGCGA->A	GCG->A	C->A
CGCGA->G	GCG->G	C->G
CGCGA->T	GCG->T	C->T
CGCGC->A	GCG->A	C->A
CGCGC->G	GCG->G	C->G
CGCGC->T	GCG->T	C->T
CGCTA->A	GCT->A	C->A
CGCTA->G	GCT->G	C->G
CGCTA->T	GCT->T	C->T
CGCTC->A	GCT->A	C->A
CGCTC->G	GCT->G	C->G
CGCTC->T	GCT->T	C->T
TTCCG->T	TCC->T	C->T
TTCCG->G	TCC->G	C->G
TTCCG->A	TCC->A	C->A
GTCCG->T	TCC->T	C->T
GTCCG->G	TCC->G	C->G
GTCCG->A	TCC->A	C->A
CTCCG->T	TCC->T	C->T
CTCCG->G	TCC->G	C->G
CTCCG->A	TCC->A	C->A
TGCCG->T	GCC->T	C->T
TGCCG->G	GCC->G	C->G
TGCCG->A	GCC->A	C->A
GGCCG->T	GCC->T	C->T
GGCCG->G	GCC->G	C->G
GGCCG->A	GCC->A	C->A
TCCCG->T	CCC->T	C->T
TCCCG->G	CCC->G	C->G
TCCCG->A	CCC->A	C->A
GCCCG->T	CCC->T	C->T
GCCCG->G	CCC->G	C->G
GCCCG->A	CCC->A	C->A
TACCG->T	ACC->T	C->T
TACCG->G	ACC->G	C->G
TACCG->A	ACC->A	C->A
GACCG->T	ACC->T	C->T
GACCG->G	ACC->G	C->G
GACCG->A	ACC->A	C->A
TTACG->T	TAC->T	A->T
TTACG->G	TAC->G	A->G
TTACG->C	TAC->C	A->C
GTACG->T	TAC->T	A->T
GTACG->G	TAC->G	A->G
GTACG->C	TAC->C	A->C
CTACG->T	TAC->T	A->T
CTACG->G	TAC->G	A->G
CTACG->C	TAC->C	A->C
TGACG->T	GAC->T	A->T
TGACG->G	GAC->G	A->G
TGACG->C	GAC->C	A->C
GGACG->T	GAC->T	A->T
GGACG->G	GAC->G	A->G
GGACG->C	GAC->C	A->C
TCACG->T	CAC->T	A->T
TCACG->G	CAC->G	A->G
TCACG->C	CAC->C	A->C
GCACG->T	CAC->T	A->T
GCACG->G	CAC->G	A->G
GCACG->C	CAC->C	A->C
TAACG->T	AAC->T	A->T
TAACG->G	AAC->G	A->G
TAACG->C	AAC->C	A->C
GAACG->T	AAC->T	A->T
GAACG->G	AAC->G	A->G
GAACG->C	AAC->C	A->C
CTAAA->C	TAA->C	A->C
CTAAA->G	TAA->G	A->G
CTAAA->T	TAA->T	A->T
CTAAC->C	TAA->C	A->C
CTAAC->G	TAA->G	A->G
CTAAC->T	TAA->T	A->T
CTAAG->C	TAA->C	A->C
CTAAG->G	TAA->G	A->G
CTAAG->T	TAA->T	A->T
CTACA->C	TAC->C	A->C
CTACA->G	TAC->G	A->G
CTACA->T	TAC->T	A->T
CTACC->C	TAC->C	A->C
CTACC->G	TAC->G	A->G
CTACC->T	TAC->T	A->T
CTAGA->C	TAG->C	A->C
CTAGA->G	TAG->G	A->G
CTAGA->T	TAG->T	A->T
CTAGC->C	TAG->C	A->C
CTAGC->G	TAG->G	A->G
CTAGC->T	TAG->T	A->T
CTATA->C	TAT->C	A->C
CTATA->G	TAT->G	A->G
CTATA->T	TAT->T	A->T
CTATC->C	TAT->C	A->C
CTATC->G	TAT->G	A->G
CTATC->T	TAT->T	A->T
CTCAA->A	TCA->A	C->A
CTCAA->G	TCA->G	C->G
CTCAA->T	TCA->T	C->T
CTCAC->A	TCA->A	C->A
CTCAC->G	TCA->G	C->G
CTCAC->T	TCA->T	C->T
CTCAG->A	TCA->A	C->A
CTCAG->G	TCA->G	C->G
CTCAG->T	TCA->T	C->T
CTCCA->A	TCC->A	C->A
CTCCA->G	TCC->G	C->G
CTCCA->T	TCC->T	C->T
CTCCC->A	TCC->A	C->A
CTCCC->G	TCC->G	C->G
CTCCC->T	TCC->T	C->T
CTCGA->A	TCG->A	C->A
CTCGA->G	TCG->G	C->G
CTCGA->T	TCG->T	C->T
CTCGC->A	TCG->A	C->A
CTCGC->G	TCG->G	C->G
CTCGC->T	TCG->T	C->T
CTCTA->A	TCT->A	C->A
CTCTA->G	TCT->G	C->G
CTCTA->T	TCT->T	C->T
CTCTC->A	TCT->A	C->A
CTCTC->G	TCT->G	C->G
CTCTC->T	TCT->T	C->T
TTCAG->T	TCA->T	C->T
TTCAG->G	TCA->G	C->G
TTCAG->A	TCA->A	C->A
GTCAG->T	TCA->T	C->T
GTCAG->G	TCA->G	C->G
GTCAG->A	TCA->A	C->A
TGCAG->T	GCA->T	C->T
TGCAG->G	GCA->G	C->G
TGCAG->A	GCA->A	C->A
GGCAG->T	GCA->T	C->T
GGCAG->G	GCA->G	C->G
GGCAG->A	GCA->A	C->A
TCCAG->T	CCA->T	C->T
TCCAG->G	CCA->G	C->G
TCCAG->A	CCA->A	C->A
GCCAG->T	CCA->T	C->T
GCCAG->G	CCA->G	C->G
GCCAG->A	CCA->A	C->A
TACAG->T	ACA->T	C->T
TACAG->G	ACA->G	C->G
TACAG->A	ACA->A	C->A
GACAG->T	ACA->T	C->T
GACAG->G	ACA->G	C->G
GACAG->A	ACA->A	C->A
TTAAG->T	TAA->T	A->T
TTAAG->G	TAA->G	A->G
TTAAG->C	TAA->C	A->C
GTAAG->T	TAA->T	A->T
GTAAG->G	TAA->G	A->G
GTAAG->C	TAA->C	A->C
TGAAG->T	GAA->T	A->T
TGAAG->G	GAA->G	A->G
TGAAG->C	GAA->C	A->C
GGAAG->T	GAA->T	A->T
GGAAG->G	GAA->G	A->G
GGAAG->C	GAA->C	A->C
TCAAG->T	CAA->T	A->T
TCAAG->G	CAA->G	A->G
TCAAG->C	CAA->C	A->C
GCAAG->T	CAA->T	A->T
GCAAG->G	CAA->G	A->G
GCAAG->C	CAA->C	A->C
TAAAG->T	AAA->T	A->T
TAAAG->G	AAA->G	A->G
TAAAG->C	AAA->C	A->C
GAAAG->T	AAA->T	A->T
GAAAG->G	AAA->G	A->G
GAAAG->C	AAA->C	A->C
GAAAA->C	AAA->C	A->C
GAAAA->G	AAA->G	A->G
GAAAA->T	AAA->T	A->T
GAAAC->C	AAA->C	A->C
GAAAC->G	AAA->G	A->G
GAAAC->T	AAA->T	A->T
GAACA->C	AAC->C	A->C
GAACA->G	AAC->G	A->G
GAACA->T	AAC->T	A->T
GAACC->C	AAC->C	A->C
GAACC->G	AAC->G	A->G
GAACC->T	AAC->T	A->T
GAAGA->C	AAG->C	A->C
GAAGA->G	AAG->G	A->G
GAAGA->T	AAG->T	A->T
GAAGC->C	AAG->C	A->C
GAAGC->G	AAG->G	A->G
GAAGC->T	AAG->T	A->T
GAATA->C	AAT->C	A->C
GAATA->G	AAT->G	A->G
GAATA->T	AAT->T	A->T
GAATC->C	AAT->C	A->C
GAATC->G	AAT->G	A->G
GAATC->T	AAT->T	A->T
GACAA->A	ACA->A	C->A
GACAA->G	ACA->G	C->G
GACAA->T	ACA->T	C->T
GACAC->A	ACA->A	C->A
GACAC->G	ACA->G	C->G
GACAC->T	ACA->T	C->T
GACCA->A	ACC->A	C->A
GACCA->G	ACC->G	C->G
GACCA->T	ACC->T	C->T
GACCC->A	ACC->A	C->A
GACCC->G	ACC->G	C->G
GACCC->T	ACC->T	C->T
GACGA->A	ACG->A	C->A
GACGA->G	ACG->G	C->G
GACGA->T	ACG->T	C->T
GACGC->A	ACG->A	C->A
GACGC->G	ACG->G	C->G
GACGC->T	ACG->T	C->T
GACTA->A	ACT->A	C->A
GACTA->G	ACT->G	C->G
GACTA->T	ACT->T	C->T
GACTC->A	ACT->A	C->A
GACTC->G	ACT->G	C->G
GACTC->T	ACT->T	C->T
TTCTC->T	TCT->T	C->T
TTCTC->G	TCT->G	C->G
TTCTC->A	TCT->A	C->A
GTCTC->T	TCT->T	C->T
GTCTC->G	TCT->G	C->G
GTCTC->A	TCT->A	C->A
TGCTC->T	GCT->T	C->T
TGCTC->G	GCT->G	C->G
TGCTC->A	GCT->A	C->A
GGCTC->T	GCT->T	C->T
GGCTC->G	GCT->G	C->G
GGCTC->A	GCT->A	C->A
TCCTC->T	CCT->T	C->T
TCCTC->G	CCT->G	C->G
TCCTC->A	CCT->A	C->A
GCCTC->T	CCT->T	C->T
GCCTC->G	CCT->G	C->G
GCCTC->A	CCT->A	C->A
TACTC->T	ACT->T	C->T
TACTC->G	ACT->G	C->G
TACTC->A	ACT->A	C->A
TTATC->T	TAT->T	A->T
TTATC->G	TAT->G	A->G
TTATC->C	TAT->C	A->C
GTATC->T	TAT->T	A->T
GTATC->G	TAT->G	A->G
GTATC->C	TAT->C	A->C
TGATC->T	GAT->T	A->T
TGATC->G	GAT->G	A->G
TGATC->C	GAT->C	A->C
GGATC->T	GAT->T	A->T
GGATC->G	GAT->G	A->G
GGATC->C	GAT->C	A->C
TCATC->T	CAT->T	A->T
TCATC->G	CAT->G	A->G
TCATC->C	CAT->C	A->C
GCATC->T	CAT->T	A->T
GCATC->G	CAT->G	A->G
GCATC->C	CAT->C	A->C
TAATC->T	AAT->T	A->T
TAATC->G	AAT->G	A->G
TAATC->C	AAT->C	A->C
GCAAA->C	CAA->C	A->C
GCAAA->G	CAA->G	A->G
GCAAA->T	CAA->T	A->T
GCAAC->C	CAA->C	A->C
GCAAC->G	CAA->G	A->G
GCAAC->T	CAA->T	A->T
GCACA->C	CAC->C	A->C
GCACA->G	CAC->G	A->G
GCACA->T	CAC->T	A->T
GCACC->C	CAC->C	A->C
GCACC->G	CAC->G	A->G
GCACC->T	CAC->T	A->T
GCAGA->C	CAG->C	A->C
GCAGA->G	CAG->G	A->G
GCAGA->T	CAG->T	A->T
GCAGC->C	CAG->C	A->C
GCAGC->G	CAG->G	A->G
GCAGC->T	CAG->T	A->T
GCATA->C	CAT->C	A->C
GCATA->G	CAT->G	A->G
GCATA->T	CAT->T	A->T
GCCAA->A	CCA->A	C->A
GCCAA->G	CCA->G	C->G
GCCAA->T	CCA->T	C->T
GCCAC->A	CCA->A	C->A
GCCAC->G	CCA->G	C->G
GCCAC->T	CCA->T	C->T
GCCCA->A	CCC->A	C->A
GCCCA->G	CCC->G	C->G
GCCCA->T	CCC->T	C->T
GCCCC->A	CCC->A	C->A
GCCCC->G	CCC->G	C->G
GCCCC->T	CCC->T	C->T
GCCGA->A	CCG->A	C->A
GCCGA->G	CCG->G	C->G
GCCGA->T	CCG->T	C->T
GCCGC->A	CCG->A	C->A
GCCGC->G	CCG->G	C->G
GCCGC->T	CCG->T	C->T
GCCTA->A	CCT->A	C->A
GCCTA->G	CCT->G	C->G
GCCTA->T	CCT->T	C->T
TTCGC->T	TCG->T	C->T
TTCGC->G	TCG->G	C->G
TTCGC->A	TCG->A	C->A
GTCGC->T	TCG->T	C->T
GTCGC->G	TCG->G	C->G
GTCGC->A	TCG->A	C->A
TGCGC->T	GCG->T	C->T
TGCGC->G	GCG->G	C->G
TGCGC->A	GCG->A	C->A
GGCGC->T	GCG->T	C->T
GGCGC->G	GCG->G	C->G
GGCGC->A	GCG->A	C->A
TCCGC->T	CCG->T	C->T
TCCGC->G	CCG->G	C->G
TCCGC->A	CCG->A	C->A
TACGC->T	ACG->T	C->T
TACGC->G	ACG->G	C->G
TACGC->A	ACG->A	C->A
TTAGC->T	TAG->T	A->T
TTAGC->G	TAG->G	A->G
TTAGC->C	TAG->C	A->C
GTAGC->T	TAG->T	A->T
GTAGC->G	TAG->G	A->G
GTAGC->C	TAG->C	A->C
TGAGC->T	GAG->T	A->T
TGAGC->G	GAG->G	A->G
TGAGC->C	GAG->C	A->C
GGAGC->T	GAG->T	A->T
GGAGC->G	GAG->G	A->G
GGAGC->C	GAG->C	A->C
TCAGC->T	CAG->T	A->T
TCAGC->G	CAG->G	A->G
TCAGC->C	CAG->C	A->C
TAAGC->T	AAG->T	A->T
TAAGC->G	AAG->G	A->G
TAAGC->C	AAG->C	A->C
GGAAA->C	GAA->C	A->C
GGAAA->G	GAA->G	A->G
GGAAA->T	GAA->T	A->T
GGAAC->C	GAA->C	A->C
GGAAC->G	GAA->G	A->G
GGAAC->T	GAA->T	A->T
GGACA->C	GAC->C	A->C
GGACA->G	GAC->G	A->G
GGACA->T	GAC->T	A->T
GGACC->C	GAC->C	A->C
GGACC->G	GAC->G	A->G
GGACC->T	GAC->T	A->T
GGAGA->C	GAG->C	A->C
GGAGA->G	GAG->G	A->G
GGAGA->T	GAG->T	A->T
GGATA->C	GAT->C	A->C
GGATA->G	GAT->G	A->G
GGATA->T	GAT->T	A->T
GGCAA->A	GCA->A	C->A
GGCAA->G	GCA->G	C->G
GGCAA->T	GCA->T	C->T
GGCAC->A	GCA->A	C->A
GGCAC->G	GCA->G	C->G
GGCAC->T	GCA->T	C->T
GGCCA->A	GCC->A	C->A
GGCCA->G	GCC->G	C->G
GGCCA->T	GCC->T	C->T
GGCCC->A	GCC->A	C->A
GGCCC->G	GCC->G	C->G
GGCCC->T	GCC->T	C->T
GGCGA->A	GCG->A	C->A
GGCGA->G	GCG->G	C->G
GGCGA->T	GCG->T	C->T
GGCTA->A	GCT->A	C->A
GGCTA->G	GCT->G	C->G
GGCTA->T	GCT->T	C->T
TTCCC->T	TCC->T	C->T
TTCCC->G	TCC->G	C->G
TTCCC->A	TCC->A	C->A
GTCCC->T	TCC->T	C->T
GTCCC->G	TCC->G	C->G
GTCCC->A	TCC->A	C->A
TGCCC->T	GCC->T	C->T
TGCCC->G	GCC->G	C->G
TGCCC->A	GCC->A	C->A
TCCCC->T	CCC->T	C->T
TCCCC->G	CCC->G	C->G
TCCCC->A	CCC->A	C->A
TACCC->T	ACC->T	C->T
TACCC->G	ACC->G	C->G
TACCC->A	ACC->A	C->A
TTACC->T	TAC->T	A->T
TTACC->G	TAC->G	A->G
TTACC->C	TAC->C	A->C
GTACC->T	TAC->T	A->T
GTACC->G	TAC->G	A->G
GTACC->C	TAC->C	A->C
TGACC->T	GAC->T	A->T
TGACC->G	GAC->G	A->G
TGACC->C	GAC->C	A->C
TCACC->T	CAC->T	A->T
TCACC->G	CAC->G	A->G
TCACC->C	CAC->C	A->C
TAACC->T	AAC->T	A->T
TAACC->G	AAC->G	A->G
TAACC->C	AAC->C	A->C
GTAAA->C	TAA->C	A->C
GTAAA->G	TAA->G	A->G
GTAAA->T	TAA->T	A->T
GTAAC->C	TAA->C	A->C
GTAAC->G	TAA->G	A->G
GTAAC->T	TAA->T	A->T
GTACA->C	TAC->C	A->C
GTACA->G	TAC->G	A->G
GTACA->T	TAC->T	A->T
GTAGA->C	TAG->C	A->C
GTAGA->G	TAG->G	A->G
GTAGA->T	TAG->T	A->T
GTATA->C	TAT->C	A->C
GTATA->G	TAT->G	A->G
GTATA->T	TAT->T	A->T
GTCAA->A	TCA->A	C->A
GTCAA->G	TCA->G	C->G
GTCAA->T	TCA->T	C->T
GTCAC->A	TCA->A	C->A
GTCAC->G	TCA->G	C->G
GTCAC->T	TCA->T	C->T
GTCCA->A	TCC->A	C->A
GTCCA->G	TCC->G	C->G
GTCCA->T	TCC->T	C->T
GTCGA->A	TCG->A	C->A
GTCGA->G	TCG->G	C->G
GTCGA->T	TCG->T	C->T
GTCTA->A	TCT->A	C->A
GTCTA->G	TCT->G	C->G
GTCTA->T	TCT->T	C->T
TTCAC->T	TCA->T	C->T
TTCAC->G	TCA->G	C->G
TTCAC->A	TCA->A	C->A
TGCAC->T	GCA->T	C->T
TGCAC->G	GCA->G	C->G
TGCAC->A	GCA->A	C->A
TCCAC->T	CCA->T	C->T
TCCAC->G	CCA->G	C->G
TCCAC->A	CCA->A	C->A
TACAC->T	ACA->T	C->T
TACAC->G	ACA->G	C->G
TACAC->A	ACA->A	C->A
TTAAC->T	TAA->T	A->T
TTAAC->G	TAA->G	A->G
TTAAC->C	TAA->C	A->C
TGAAC->T	GAA->T	A->T
TGAAC->G	GAA->G	A->G
TGAAC->C	GAA->C	A->C
TCAAC->T	CAA->T	A->T
TCAAC->G	CAA->G	A->G
TCAAC->C	CAA->C	A->C
TAAAC->T	AAA->T	A->T
TAAAC->G	AAA->G	A->G
TAAAC->C	AAA->C	A->C
TAAAA->C	AAA->C	A->C
TAAAA->G	AAA->G	A->G
TAAAA->T	AAA->T	A->T
TAACA->C	AAC->C	A->C
TAACA->G	AAC->G	A->G
TAACA->T	AAC->T	A->T
TAAGA->C	AAG->C	A->C
TAAGA->G	AAG->G	A->G
TAAGA->T	AAG->T	A->T
TAATA->C	AAT->C	A->C
TAATA->G	AAT->G	A->G
TAATA->T	AAT->T	A->T
TACAA->A	ACA->A	C->A
TACAA->G	ACA->G	C->G
TACAA->T	ACA->T	C->T
TACCA->A	ACC->A	C->A
TACCA->G	ACC->G	C->G
TACCA->T	ACC->T	C->T
TACGA->A	ACG->A	C->A
TACGA->G	ACG->G	C->G
TACGA->T	ACG->T	C->T
TACTA->A	ACT->A	C->A
TACTA->G	ACT->G	C->G
TACTA->T	ACT->T	C->T
TTCTA->T	TCT->T	C->T
TTCTA->G	TCT->G	C->G
TTCTA->A	TCT->A	C->A
TGCTA->T	GCT->T	C->T
TGCTA->G	GCT->G	C->G
TGCTA->A	GCT->A	C->A
TCCTA->T	CCT->T	C->T
TCCTA->G	CCT->G	C->G
TCCTA->A	CCT->A	C->A
TTATA->T	TAT->T	A->T
TTATA->G	TAT->G	A->G
TTATA->C	TAT->C	A->C
TGATA->T	GAT->T	A->T
TGATA->G	GAT->G	A->G
TGATA->C	GAT->C	A->C
TCATA->T	CAT->T	A->T
TCATA->G	CAT->G	A->G
TCATA->C	CAT->C	A->C
TCAAA->C	CAA->C	A->C
TCAAA->G	CAA->G	A->G
TCAAA->T	CAA->T	A->T
TCACA->C	CAC->C	A->C
TCACA->G	CAC->G	A->G
TCACA->T	CAC->T	A->T
TCAGA->C	CAG->C	A->C
TCAGA->G	CAG->G	A->G
TCAGA->T	CAG->T	A->T
TCCAA->A	CCA->A	C->A
TCCAA->G	CCA->G	C->G
TCCAA->T	CCA->T	C->T
TCCCA->A	CCC->A	C->A
TCCCA->G	CCC->G	C->G
TCCCA->T	CCC->T	C->T
TCCGA->A	CCG->A	C->A
TCCGA->G	CCG->G	C->G
TCCGA->T	CCG->T	C->T
TTCGA->T	TCG->T	C->T
TTCGA->G	TCG->G	C->G
TTCGA->A	TCG->A	C->A
TGCGA->T	GCG->T	C->T
TGCGA->G	GCG->G	C->G
TGCGA->A	GCG->A	C->A
TTAGA->T	TAG->T	A->T
TTAGA->G	TAG->G	A->G
TTAGA->C	TAG->C	A->C
TGAGA->T	GAG->T	A->T
TGAGA->G	GAG->G	A->G
TGAGA->C	GAG->C	A->C
TGAAA->C	GAA->C	A->C
TGAAA->G	GAA->G	A->G
TGAAA->T	GAA->T	A->T
TGACA->C	GAC->C	A->C
TGACA->G	GAC->G	A->G
TGACA->T	GAC->T	A->T
TGCAA->A	GCA->A	C->A
TGCAA->G	GCA->G	C->G
TGCAA->T	GCA->T	C->T
TGCCA->A	GCC->A	C->A
TGCCA->G	GCC->G	C->G
TGCCA->T	GCC->T	C->T
TTCCA->T	TCC->T	C->T
TTCCA->G	TCC->G	C->G
TTCCA->A	TCC->A	C->A
TTACA->T	TAC->T	A->T
TTACA->G	TAC->G	A->G
TTACA->C	TAC->C	A->C
TTAAA->C	TAA->C	A->C
TTAAA->G	TAA->G	A->G
TTAAA->T	TAA->T	A->T
TTCAA->A	TCA->A	C->A
TTCAA->G	TCA->G	C->G
TTCAA->T	TCA->T	C->T
