Context	 X1mer
AAA->C	A->C
AAA->G	A->G
AAA->T	A->T
AAC->C	A->C
AAC->G	A->G
AAC->T	A->T
AAG->C	A->C
AAG->G	A->G
AAG->T	A->T
AAT->C	A->C
AAT->G	A->G
AAT->T	A->T
ACA->A	C->A
ACA->G	C->G
ACA->T	C->T
ACC->A	C->A
ACC->G	C->G
ACC->T	C->T
ACG->A	C->A
ACG->G	C->G
ACG->T	C->T
ACT->A	C->A
ACT->G	C->G
ACT->T	C->T
TCT->T	C->T
TCT->G	C->G
TCT->A	C->A
GCT->T	C->T
GCT->G	C->G
GCT->A	C->A
CCT->T	C->T
CCT->G	C->G
CCT->A	C->A
TAT->T	A->T
TAT->G	A->G
TAT->C	A->C
GAT->T	A->T
GAT->G	A->G
GAT->C	A->C
CAT->T	A->T
CAT->G	A->G
CAT->C	A->C
CAA->C	A->C
CAA->G	A->G
CAA->T	A->T
CAC->C	A->C
CAC->G	A->G
CAC->T	A->T
CAG->C	A->C
CAG->G	A->G
CAG->T	A->T
CCA->A	C->A
CCA->G	C->G
CCA->T	C->T
CCC->A	C->A
CCC->G	C->G
CCC->T	C->T
CCG->A	C->A
CCG->G	C->G
CCG->T	C->T
TCG->T	C->T
TCG->G	C->G
TCG->A	C->A
GCG->T	C->T
GCG->G	C->G
GCG->A	C->A
TAG->T	A->T
TAG->G	A->G
TAG->C	A->C
GAG->T	A->T
GAG->G	A->G
GAG->C	A->C
GAA->C	A->C
GAA->G	A->G
GAA->T	A->T
GAC->C	A->C
GAC->G	A->G
GAC->T	A->T
GCA->A	C->A
GCA->G	C->G
GCA->T	C->T
GCC->A	C->A
GCC->G	C->G
GCC->T	C->T
TCC->T	C->T
TCC->G	C->G
TCC->A	C->A
TAC->T	A->T
TAC->G	A->G
TAC->C	A->C
TAA->C	A->C
TAA->G	A->G
TAA->T	A->T
TCA->A	C->A
TCA->G	C->G
TCA->T	C->T
